Zuhause
RAIN_DULL
1.5
06 01 01 01 01 05 00 00 00 00 00 00
02 07 07 07 07 02 00 00 00 06 01 05
02 07 07 07 07 02 00 00 00 07 07 02
02 07 07 07 07 02 00 00 00 02 07 02
04 01 01 05 07 04 01 01 01 03 07 02
02 07 07 02 07 07 07 11 07 07 07 02
02 07 07 07 07 07 07 07 07 07 07 02
02 07 07 02 07 07 07 07 07 07 07 02
02 07 07 02 07 07 07 07 07 07 07 02
04 01 01 01 01 01 01 01 01 01 01 04